INCLUDE "data/pokemon/base_stats/leef.asm"	;152 - chikorita
INCLUDE "data/pokemon/base_stats/blossomole.asm"	;153 - bayleef
INCLUDE "data/pokemon/base_stats/blossomite.asm"	;154 - meganium
INCLUDE "data/pokemon/base_stats/flambear.asm"	;155 - cyndaquil
INCLUDE "data/pokemon/base_stats/volbear.asm"	;156 - quilava
INCLUDE "data/pokemon/base_stats/dynabear.asm"	;157 - typhlosion
INCLUDE "data/pokemon/base_stats/cruz.asm"	;158 - totodile
INCLUDE "data/pokemon/base_stats/aqua.asm"	;159 - croconaw
INCLUDE "data/pokemon/base_stats/aquaria.asm"	;160 - feraligatr
INCLUDE "data/pokemon/base_stats/hoothoot.asm"	;161 - sentret
INCLUDE "data/pokemon/base_stats/hoohoo.asm"	;162 - furret
INCLUDE "data/pokemon/base_stats/mareep.asm"	;163 - hoothoot
INCLUDE "data/pokemon/base_stats/flaaffy.asm"	;164 - noctowl
INCLUDE "data/pokemon/base_stats/ampharos.asm"	;165 - ledyba
INCLUDE "data/pokemon/base_stats/trifox.asm"	;166 - ledian
INCLUDE "data/pokemon/base_stats/tangel.asm"	;167 - spinarak
INCLUDE "data/pokemon/base_stats/gelanla.asm"	;168 - ariados
INCLUDE "data/pokemon/base_stats/rayleep.asm"	;169 - crobat
INCLUDE "data/pokemon/base_stats/qwilfish.asm"	;170 - chinchou
INCLUDE "data/pokemon/base_stats/numpuff.asm"	;171 - lanturn
INCLUDE "data/pokemon/base_stats/pichu.asm"	;172 - pichu
INCLUDE "data/pokemon/base_stats/cleffa.asm"	;173 - cleffa
INCLUDE "data/pokemon/base_stats/igglybuff.asm"	;174 - igglybuff
INCLUDE "data/pokemon/base_stats/quagsire.asm"	;175 - togepi
INCLUDE "data/pokemon/base_stats/natu.asm"	;176 - togetic
INCLUDE "data/pokemon/base_stats/xatu.asm"	;177 - natu
INCLUDE "data/pokemon/base_stats/golppy.asm"	;178 - xatu
INCLUDE "data/pokemon/base_stats/marill.asm"	;179 - mareep
INCLUDE "data/pokemon/base_stats/sunmola.asm"	;180 - flaaffy
INCLUDE "data/pokemon/base_stats/anchorage.asm"	;181 - ampharos
INCLUDE "data/pokemon/base_stats/grotess.asm"	;182 - bellossom
INCLUDE "data/pokemon/base_stats/crobat.asm"	;183 - marill
INCLUDE "data/pokemon/base_stats/parasy.asm"	;184 - azumarill
INCLUDE "data/pokemon/base_stats/spinarak.asm"	;185 - sudowoodo
INCLUDE "data/pokemon/base_stats/ariados.asm"	;186 - politoed
INCLUDE "data/pokemon/base_stats/skarmory.asm"	;187 - hoppip
INCLUDE "data/pokemon/base_stats/lykwyse.asm"	;188 - skiploom
INCLUDE "data/pokemon/base_stats/douno.asm"	;189 - jumpluff
INCLUDE "data/pokemon/base_stats/sunflora.asm"	;190 - aipom
INCLUDE "data/pokemon/base_stats/phanpy.asm"	;191 - sunkern
INCLUDE "data/pokemon/base_stats/donphan.asm"	;192 - sunflora
INCLUDE "data/pokemon/base_stats/twinz.asm"	;193 - yanma
INCLUDE "data/pokemon/base_stats/girafarig.asm"	;194 - wooper
INCLUDE "data/pokemon/base_stats/smeargle.asm"	;195 - quagsire
INCLUDE "data/pokemon/base_stats/meowsy.asm"	;196 - espeon
INCLUDE "data/pokemon/base_stats/rinring.asm"	;197 - umbreon
INCLUDE "data/pokemon/base_stats/bellboyant.asm"	;198 - murkrow
INCLUDE "data/pokemon/base_stats/politoed.asm"	;199 - slowking
INCLUDE "data/pokemon/base_stats/slowking.asm"	;200 - misdreavus
INCLUDE "data/pokemon/base_stats/unown.asm"	;201 - unown
INCLUDE "data/pokemon/base_stats/ledyba.asm"	;202 - wobbuffet
INCLUDE "data/pokemon/base_stats/tripstar.asm"	;203 - girafarig
INCLUDE "data/pokemon/base_stats/minicorn.asm"	;204 - pineco
INCLUDE "data/pokemon/base_stats/espeon.asm"	;205 - forretress
INCLUDE "data/pokemon/base_stats/umbreon.asm"	;206 - dunsparce
INCLUDE "data/pokemon/base_stats/turbann.asm"	;207 - gligar
INCLUDE "data/pokemon/base_stats/grimey.asm"	;208 - steelix
INCLUDE "data/pokemon/base_stats/remoraid.asm"	;209 - snubbull
INCLUDE "data/pokemon/base_stats/octillery.asm"	;210 - granbull
INCLUDE "data/pokemon/base_stats/gohng.asm"	;211 - qwilfish
INCLUDE "data/pokemon/base_stats/hitmontop.asm"	;212 - scizor
INCLUDE "data/pokemon/base_stats/puddi.asm"	;213 - shuckle
INCLUDE "data/pokemon/base_stats/lefmew.asm"	;214 - heracross
INCLUDE "data/pokemon/base_stats/dandemew.asm"	;215 - sneasel
INCLUDE "data/pokemon/base_stats/cottomew.asm"	;216 - teddiursa
INCLUDE "data/pokemon/base_stats/ballerine.asm"	;217 - ursaring
INCLUDE "data/pokemon/base_stats/smoochum.asm"	;218 - slugma
INCLUDE "data/pokemon/base_stats/elekid.asm"	;219 - magcargo
INCLUDE "data/pokemon/base_stats/magby.asm"	;220 - swinub
INCLUDE "data/pokemon/base_stats/bellossom.asm"	;221 - piloswine
INCLUDE "data/pokemon/base_stats/belmitt.asm"	;222 - corsola
INCLUDE "data/pokemon/base_stats/miltank.asm"	;223 - remoraid
INCLUDE "data/pokemon/base_stats/bomseel.asm"	;224 - octillery
INCLUDE "data/pokemon/base_stats/delibird.asm"	;225 - delibird
INCLUDE "data/pokemon/base_stats/kotora.asm"	;226 - mantine
INCLUDE "data/pokemon/base_stats/raitora.asm"	;227 - skarmory
INCLUDE "data/pokemon/base_stats/madame.asm"	;228 - houndour
INCLUDE "data/pokemon/base_stats/kurstraw.asm"	;229 - houndoom
INCLUDE "data/pokemon/base_stats/pangshi.asm"	;230 - kingdra
INCLUDE "data/pokemon/base_stats/murkrow.asm"	;231 - phanpy
INCLUDE "data/pokemon/base_stats/blissey.asm"	;232 - donphan
INCLUDE "data/pokemon/base_stats/scizor.asm"	;233 - porygon2
INCLUDE "data/pokemon/base_stats/plux.asm"	;234 - stantler
INCLUDE "data/pokemon/base_stats/houndour.asm"	;235 - smeargle
INCLUDE "data/pokemon/base_stats/houndoom.asm"	;236 - tyrogue
INCLUDE "data/pokemon/base_stats/wolfman.asm"	;237 - hitmontop
INCLUDE "data/pokemon/base_stats/warwolf.asm"	;238 - smoochum
INCLUDE "data/pokemon/base_stats/porygon2.asm"	;239 - elekid
INCLUDE "data/pokemon/base_stats/likk.asm"	;240 - magby
INCLUDE "data/pokemon/base_stats/steelix.asm"	;241 - miltank
INCLUDE "data/pokemon/base_stats/kingdra.asm"	;242 - blissey
INCLUDE "data/pokemon/base_stats/rai.asm"	;243 - raikou
INCLUDE "data/pokemon/base_stats/en.asm"	;244 - entei
INCLUDE "data/pokemon/base_stats/sui.asm"	;245 - suicune
INCLUDE "data/pokemon/base_stats/sneasel.asm"	;246 - larvitar
INCLUDE "data/pokemon/base_stats/ho_oh.asm"	;247 - pupitar
INCLUDE "data/pokemon/base_stats/togepi.asm"	;248 - tyranitar
INCLUDE "data/pokemon/base_stats/snubbull.asm"	;249 - lugia
INCLUDE "data/pokemon/base_stats/aipom.asm"	;250 - ho_oh
INCLUDE "data/pokemon/base_stats/leafeon.asm"	;251 - celebi