LeefPokedexEntry::     INCLUDE "data/pokemon/dex_entries/leef.asm"
BlossomolePokedexEntry::     INCLUDE "data/pokemon/dex_entries/blossomole.asm"
BlossomitePokedexEntry::     INCLUDE "data/pokemon/dex_entries/blossomite.asm"
FlambearPokedexEntry::     INCLUDE "data/pokemon/dex_entries/flambear.asm"
VolbearPokedexEntry::     INCLUDE "data/pokemon/dex_entries/volbear.asm"
DynabearPokedexEntry::     INCLUDE "data/pokemon/dex_entries/dynabear.asm"
CruzPokedexEntry::     INCLUDE "data/pokemon/dex_entries/cruz.asm"
AquaPokedexEntry::     INCLUDE "data/pokemon/dex_entries/aqua.asm"
AquariaPokedexEntry::     INCLUDE "data/pokemon/dex_entries/aquaria.asm"
HoothootPokedexEntry::     INCLUDE "data/pokemon/dex_entries/hoothoot.asm"
HoohooPokedexEntry::     INCLUDE "data/pokemon/dex_entries/hoohoo.asm"
MareepPokedexEntry::     INCLUDE "data/pokemon/dex_entries/mareep.asm"
FlaaffyPokedexEntry::     INCLUDE "data/pokemon/dex_entries/flaaffy.asm"
AmpharosPokedexEntry::     INCLUDE "data/pokemon/dex_entries/ampharos.asm"
TrifoxPokedexEntry::     INCLUDE "data/pokemon/dex_entries/trifox.asm"
TangelPokedexEntry::     INCLUDE "data/pokemon/dex_entries/tangel.asm"
GelanlaPokedexEntry::     INCLUDE "data/pokemon/dex_entries/gelanla.asm"
RayleepPokedexEntry::     INCLUDE "data/pokemon/dex_entries/rayleep.asm"
QwilfishPokedexEntry::     INCLUDE "data/pokemon/dex_entries/qwilfish.asm"
NumpuffPokedexEntry::     INCLUDE "data/pokemon/dex_entries/numpuff.asm"
PichuPokedexEntry::     INCLUDE "data/pokemon/dex_entries/pichu.asm"
CleffaPokedexEntry::     INCLUDE "data/pokemon/dex_entries/cleffa.asm"
IgglybuffPokedexEntry::     INCLUDE "data/pokemon/dex_entries/igglybuff.asm"
QuagsirePokedexEntry::     INCLUDE "data/pokemon/dex_entries/quagsire.asm"
NatuPokedexEntry::     INCLUDE "data/pokemon/dex_entries/natu.asm"
XatuPokedexEntry::     INCLUDE "data/pokemon/dex_entries/xatu.asm"
GolppyPokedexEntry::     INCLUDE "data/pokemon/dex_entries/golppy.asm"
MarillPokedexEntry::     INCLUDE "data/pokemon/dex_entries/marill.asm"
SunmolaPokedexEntry::     INCLUDE "data/pokemon/dex_entries/sunmola.asm"
AnchoragePokedexEntry::     INCLUDE "data/pokemon/dex_entries/anchorage.asm"
GrotessPokedexEntry::     INCLUDE "data/pokemon/dex_entries/grotess.asm"
CrobatPokedexEntry::     INCLUDE "data/pokemon/dex_entries/crobat.asm"
ParasyPokedexEntry::     INCLUDE "data/pokemon/dex_entries/parasy.asm"
SpinarakPokedexEntry::     INCLUDE "data/pokemon/dex_entries/spinarak.asm"
AriadosPokedexEntry::     INCLUDE "data/pokemon/dex_entries/ariados.asm"
SkarmoryPokedexEntry::     INCLUDE "data/pokemon/dex_entries/skarmory.asm"
LykwysePokedexEntry::     INCLUDE "data/pokemon/dex_entries/lykwyse.asm"
DounoPokedexEntry::     INCLUDE "data/pokemon/dex_entries/douno.asm"
SunfloraPokedexEntry::     INCLUDE "data/pokemon/dex_entries/sunflora.asm"
PhanpyPokedexEntry::     INCLUDE "data/pokemon/dex_entries/phanpy.asm"
DonphanPokedexEntry::     INCLUDE "data/pokemon/dex_entries/donphan.asm"
TwinzPokedexEntry::     INCLUDE "data/pokemon/dex_entries/twinz.asm"
GirafarigPokedexEntry::     INCLUDE "data/pokemon/dex_entries/girafarig.asm"
SmearglePokedexEntry::     INCLUDE "data/pokemon/dex_entries/smeargle.asm"
MeowsyPokedexEntry::     INCLUDE "data/pokemon/dex_entries/meowsy.asm"
RinringPokedexEntry::     INCLUDE "data/pokemon/dex_entries/rinring.asm"
BellboyantPokedexEntry::     INCLUDE "data/pokemon/dex_entries/bellboyant.asm"
PolitoedPokedexEntry::     INCLUDE "data/pokemon/dex_entries/politoed.asm"
SlowkingPokedexEntry::     INCLUDE "data/pokemon/dex_entries/slowking.asm"
UnownPokedexEntry::     INCLUDE "data/pokemon/dex_entries/unown.asm"
LedybaPokedexEntry::     INCLUDE "data/pokemon/dex_entries/ledyba.asm"
TripstarPokedexEntry::     INCLUDE "data/pokemon/dex_entries/tripstar.asm"
MinicornPokedexEntry::     INCLUDE "data/pokemon/dex_entries/minicorn.asm"
EspeonPokedexEntry::     INCLUDE "data/pokemon/dex_entries/espeon.asm"
UmbreonPokedexEntry::     INCLUDE "data/pokemon/dex_entries/umbreon.asm"
TurbannPokedexEntry::     INCLUDE "data/pokemon/dex_entries/turbann.asm"
GrimeyPokedexEntry::     INCLUDE "data/pokemon/dex_entries/grimey.asm"
RemoraidPokedexEntry::     INCLUDE "data/pokemon/dex_entries/remoraid.asm"
OctilleryPokedexEntry::     INCLUDE "data/pokemon/dex_entries/octillery.asm"
GohngPokedexEntry::     INCLUDE "data/pokemon/dex_entries/gohng.asm"
HitmontopPokedexEntry::     INCLUDE "data/pokemon/dex_entries/hitmontop.asm"
PuddiPokedexEntry::     INCLUDE "data/pokemon/dex_entries/puddi.asm"
LefmewPokedexEntry::     INCLUDE "data/pokemon/dex_entries/lefmew.asm"
DandemewPokedexEntry::     INCLUDE "data/pokemon/dex_entries/dandemew.asm"
CottomewPokedexEntry::     INCLUDE "data/pokemon/dex_entries/cottomew.asm"
BallerinePokedexEntry::     INCLUDE "data/pokemon/dex_entries/ballerine.asm"
SmoochumPokedexEntry::     INCLUDE "data/pokemon/dex_entries/smoochum.asm"
ElekidPokedexEntry::     INCLUDE "data/pokemon/dex_entries/elekid.asm"
MagbyPokedexEntry::     INCLUDE "data/pokemon/dex_entries/magby.asm"
BellossomPokedexEntry::     INCLUDE "data/pokemon/dex_entries/bellossom.asm"
BelmittPokedexEntry::     INCLUDE "data/pokemon/dex_entries/belmitt.asm"
MiltankPokedexEntry::     INCLUDE "data/pokemon/dex_entries/miltank.asm"
BomseelPokedexEntry::     INCLUDE "data/pokemon/dex_entries/bomseel.asm"
DelibirdPokedexEntry::     INCLUDE "data/pokemon/dex_entries/delibird.asm"
KotoraPokedexEntry::     INCLUDE "data/pokemon/dex_entries/kotora.asm"
RaitoraPokedexEntry::     INCLUDE "data/pokemon/dex_entries/raitora.asm"
MadamePokedexEntry::     INCLUDE "data/pokemon/dex_entries/madame.asm"
KurstrawPokedexEntry::     INCLUDE "data/pokemon/dex_entries/kurstraw.asm"
PangshiPokedexEntry::     INCLUDE "data/pokemon/dex_entries/pangshi.asm"
MurkrowPokedexEntry::     INCLUDE "data/pokemon/dex_entries/murkrow.asm"
BlisseyPokedexEntry::     INCLUDE "data/pokemon/dex_entries/blissey.asm"
ScizorPokedexEntry::     INCLUDE "data/pokemon/dex_entries/scizor.asm"
PluxPokedexEntry::     INCLUDE "data/pokemon/dex_entries/plux.asm"
HoundourPokedexEntry::     INCLUDE "data/pokemon/dex_entries/houndour.asm"
HoundoomPokedexEntry::     INCLUDE "data/pokemon/dex_entries/houndoom.asm"
WolfmanPokedexEntry::     INCLUDE "data/pokemon/dex_entries/wolfman.asm"
WarwolfPokedexEntry::     INCLUDE "data/pokemon/dex_entries/warwolf.asm"
Porygon2PokedexEntry::     INCLUDE "data/pokemon/dex_entries/porygon2.asm"
LikkPokedexEntry::     INCLUDE "data/pokemon/dex_entries/likk.asm"
SteelixPokedexEntry::     INCLUDE "data/pokemon/dex_entries/steelix.asm"
KingdraPokedexEntry::     INCLUDE "data/pokemon/dex_entries/kingdra.asm"
RaiPokedexEntry::     INCLUDE "data/pokemon/dex_entries/rai.asm"
EnPokedexEntry::     INCLUDE "data/pokemon/dex_entries/en.asm"
SuiPokedexEntry::     INCLUDE "data/pokemon/dex_entries/sui.asm"
SneaselPokedexEntry::     INCLUDE "data/pokemon/dex_entries/sneasel.asm"
Ho_OhPokedexEntry::     INCLUDE "data/pokemon/dex_entries/ho_oh.asm"
TogepiPokedexEntry::     INCLUDE "data/pokemon/dex_entries/togepi.asm"
SnubbullPokedexEntry::     INCLUDE "data/pokemon/dex_entries/snubbull.asm"
AipomPokedexEntry::     INCLUDE "data/pokemon/dex_entries/aipom.asm"
LeafeonPokedexEntry::     INCLUDE "data/pokemon/dex_entries/leafeon.asm"